
25 25
59 59 59 59 59 59 59 59 59 59 59 59 59 59 59 59 59 59 59 59 59 59 59 59 59 
59 8 8 8 8 8 8 8 8 8 8 8 8 8 8 8 8 8 8 8 8 8 8 8 59 
59 8 8 8 8 8 8 8 8 8 8 8 8 8 8 8 8 8 8 8 8 8 8 8 59 
59 8 8 24 22 22 22 22 22 22 22 22 22 22 22 28 10 10 10 10 10 8 8 8 59 
59 8 8 25 15 15 15 15 15 15 15 15 15 15 15 25 10 10 10 10 10 8 8 8 59 
59 8 8 25 8 8 17 8 8 7 15 8 8 8 8 52 8 8 10 8 10 8 8 8 59 
59 8 8 52 8 8 17 7 15 15 15 8 8 8 8 25 8 8 10 8 10 8 8 8 59 
59 8 8 25 8 8 8 8 8 8 8 15 8 8 8 25 8 8 10 8 10 8 8 8 59 
59 8 8 25 8 8 17 8 8 8 8 8 8 8 8 25 8 8 8 8 10 8 8 8 59 
59 8 8 21 22 22 22 22 22 22 22 22 22 22 22 30 10 10 10 10 10 8 8 8 59 
59 8 8 8 8 8 8 8 8 8 8 8 8 8 8 8 8 8 8 8 8 8 8 8 59 
59 8 8 8 8 8 8 8 8 8 8 8 8 8 8 8 8 8 8 8 8 8 8 8 59 
59 8 8 8 8 8 8 8 8 8 8 8 8 8 8 8 16 16 16 5 16 16 16 16 59 
59 8 8 8 8 8 8 8 8 8 8 8 8 8 8 8 16 5 5 5 5 5 5 5 59 
59 8 8 8 8 8 8 8 8 8 8 8 8 8 8 8 16 5 5 5 5 5 5 5 59 
59 8 8 8 8 8 8 8 8 8 8 8 8 8 8 8 16 16 16 16 16 16 5 55 59 
59 8 8 8 8 8 8 8 8 8 8 8 8 8 8 8 16 16 16 16 16 16 16 16 59 
59 8 8 8 8 8 8 8 8 8 8 8 8 8 8 8 10 10 10 10 10 10 10 10 59 
59 8 8 8 8 8 8 8 8 8 8 8 8 8 8 8 10 8 8 8 8 8 8 8 59 
59 8 8 8 8 8 8 8 8 8 8 8 8 8 8 8 20 22 22 22 22 22 22 28 59 
59 8 8 8 8 8 8 8 8 8 8 8 8 8 8 8 25 8 8 8 8 8 8 25 59 
59 8 8 8 8 8 8 8 8 10 8 10 10 8 10 10 8 8 8 8 8 8 8 25 59 
59 8 8 8 8 8 8 8 8 8 8 8 8 8 8 8 25 8 8 8 8 8 8 25 59 
59 8 8 8 8 8 8 8 8 8 8 8 8 8 8 8 25 8 8 8 8 8 8 25 59 
59 59 59 59 59 59 59 59 59 59 59 59 59 59 59 59 59 59 59 59 59 59 59 59 59


Thife TH 2 2

2
HeardGuard GR7 22 8 1 3 BF LOOK_LEFT
HeardGuard GR6 13 22 1 2 BF UP LOOK_UP LOOK_DOWN UP UP UP LEFT LEFT LEFT LEFT LEFT LEFT DOWN DOWN DOWN


3
Key K2 22 23
Key K1 9 5
HeardlessPotion P3 14 8