25 25
59 59 59 59 59 59 59 59 59 59 59 59 59 59 59 59 59 59 59 59 59 59 59 59 59 
59 1 1 1 1 25 1 1 1 20 1 1 1 20 1 1 17 8 8 56 17 8 8 8 59 
59 21 22 23 1 25 1 1 1 25 1 1 1 25 1 1 17 8 8 8 17 8 8 8 59 
59 16 16 16 1 25 1 1 1 25 1 1 1 25 1 1 17 8 8 8 17 8 8 8 59 
59 1 1 1 1 25 1 1 1 25 1 1 1 25 1 1 17 8 17 17 17 8 8 8 59 
59 1 1 1 1 25 1 1 1 26 23 52 21 30 1 1 17 8 8 8 8 8 8 8 59 
59 1 22 22 22 30 1 1 1 1 1 1 1 1 1 1 17 8 8 8 8 8 8 8 59 
59 1 11 11 11 11 1 1 1 1 1 1 1 1 1 1 17 17 17 17 17 52 17 17 59 
59 1 1 1 1 1 1 1 1 1 1 1 1 1 1 1 1 1 1 1 1 1 1 1 59 
59 1 1 1 1 1 1 1 1 1 1 1 1 1 1 1 1 1 1 1 1 1 1 1 59 
59 1 1 1 1 1 1 1 1 1 1 1 1 1 1 1 1 1 1 1 1 1 1 1 59 
59 1 1 1 1 1 1 1 1 1 1 1 1 1 18 1 1 1 1 1 1 1 1 1 59 
59 1 1 1 1 18 1 1 1 1 1 1 1 1 16 1 1 1 1 1 1 1 1 1 59 
59 1 1 1 1 16 1 1 1 1 1 1 1 1 1 1 1 1 1 1 1 1 1 1 59 
59 1 1 1 1 1 1 1 1 1 1 1 1 1 1 1 1 1 1 1 1 1 1 1 59 
59 1 1 1 1 1 1 1 1 1 1 1 1 1 1 1 1 1 1 1 1 1 1 1 59 
59 1 1 1 1 1 1 1 1 1 1 1 1 1 1 1 1 1 1 1 1 1 1 1 59 
59 1 1 1 1 1 1 1 1 1 1 1 1 1 1 1 36 37 37 37 37 37 37 40 41 
59 1 1 1 1 1 1 1 1 1 1 1 1 1 1 1 33 35 1 1 1 1 1 34 35 
59 1 1 1 1 1 1 18 1 1 1 1 1 1 1 1 33 35 1 1 1 1 1 34 35 
59 1 1 1 1 1 1 17 1 1 1 1 1 1 1 1 52 1 1 1 1 1 1 34 35 
59 1 1 1 1 1 1 1 1 1 1 1 1 1 1 1 33 35 1 1 1 1 1 34 35 
59 1 1 1 1 1 1 1 1 1 1 1 1 1 1 1 33 35 1 1 1 1 1 34 35 
59 1 1 1 1 1 1 1 1 1 1 1 1 1 1 1 33 34 40 40 40 40 40 34 35 
59 59 59 59 59 59 59 59 59 59 59 59 59 59 59 59 43 45 45 45 45 45 45 45 46

Thife TH 11 4

2
SeeGuard GR1 21 16 1 1.8  BF LOOK_UP
SeeGuard GR2 3 22 1.2 2 BF RIGHT RIGHT RIGHT RIGHT LOOK_UP LOOK_UP  RIGHT RIGHT RIGHT RIGHT RIGHT RIGHT RIGHT UP UP UP UP UP UP UP UP

4
Key K1 18 22
Key K2 12 1
Key K1 4 1
InvisibilityPotion  P3 22 22