30 30
60 21 22 22 22 22 22 22 22 22 22 22 22 22 31 22 22 22 22 22 22 22 22 22 22 22 22 22 22 28 
60 15 15 15 15 15 15 15 15 15 15 15 15 15 25 15 15 15 12 12 12 15 15 15 15 15 15 15 15 25 
60 1 1 1 1 1 1 1 1 25 60 60 60 60 25 1 1 1 1 1 1 1 1 1 1 1 1 1 1 25 
60 1 1 1 1 1 1 1 1 25 60 60 60 60 25 1 1 1 1 1 1 1 1 1 1 1 1 1 1 25 
60 1 1 1 1 1 1 1 1 25 60 60 60 60 25 1 1 1 1 1 1 1 1 1 1 1 1 1 1 25 
60 1 1 1 1 1 1 1 1 25 60 60 60 60 25 1 1 1 1 1 1 1 1 1 1 1 1 1 1 25 
60 1 1 1 1 1 1 1 1 25 60 60 60 60 25 1 1 1 1 1 1 1 1 1 1 1 1 1 1 25 
60 1 1 1 1 1 1 1 1 25 60 60 60 60 25 1 1 1 1 1 1 1 55 1 1 1 1 1 1 25 
60 1 1 1 1 1 1 1 1 25 60 60 60 60 25 1 1 1 1 1 1 1 1 1 1 1 1 1 1 25 
60 21 22 28 1 1 1 24 22 30 60 60 60 60 25 1 1 1 1 1 1 1 1 1 1 1 1 1 1 25 
60 15 15 25 1 1 1 25 15 15 60 60 60 60 25 1 1 1 1 1 1 1 1 1 1 1 1 1 1 25 
60 60 60 25 1 1 1 25 60 60 60 60 60 60 25 1 1 1 1 1 1 1 1 1 1 1 1 1 1 25 
60 60 60 25 1 1 1 25 60 60 60 60 60 60 25 1 1 1 1 1 1 1 1 1 1 1 1 1 1 25 
60 60 60 25 1 1 1 25 60 60 60 60 60 60 19 1 21 22 22 22 22 22 22 22 22 22 22 22 22 30 
60 60 60 25 1 1 1 25 60 60 60 60 60 60 11 52 12 15 15 15 15 15 15 15 15 15 15 15 15 17 
60 60 60 25 1 1 1 26 22 22 22 22 22 22 23 10 10 10 10 10 10 10 10 10 10 8 8 8 8 60 
60 60 60 25 1 1 1 11 15 15 15 15 15 15 15 10 10 10 10 10 10 10 10 10 10 39 40 41 8 60 
60 60 60 25 1 1 1 2 2 2 2 2 2 2 2 10 10 10 10 10 10 10 10 10 10 33 51 35 8 60 
60 60 60 25 1 1 1 2 2 2 2 2 2 2 2 10 10 10 10 10 10 10 10 10 10 44 45 46 8 60 
60 60 60 26 22 22 22 22 22 22 22 22 22 22 23 10 10 10 10 10 10 10 10 10 10 10 8 8 8 60 
60 60 60 11 15 15 15 15 15 15 15 15 15 15 15 10 10 10 10 10 10 10 10 10 10 10 8 8 8 60 
60 60 60 60 60 60 60 60 60 60 60 60 60 60 60 10 10 10 10 10 10 10 10 10 10 8 8 8 8 60 
60 60 60 60 60 60 60 60 60 60 60 60 60 60 60 10 10 10 10 10 10 10 10 10 10 8 8 8 8 60 
60 60 60 60 60 60 60 60 60 60 60 60 60 60 60 10 10 10 10 10 10 10 10 10 10 8 8 8 8 60 
60 60 60 60 60 60 60 60 60 60 60 60 60 60 60 10 10 10 10 10 10 10 10 10 10 8 8 8 8 60 
60 60 60 60 60 60 60 60 60 60 60 60 60 60 60 10 10 10 10 10 10 10 10 10 10 8 8 8 8 60 
60 60 60 60 60 60 60 60 60 60 60 60 60 60 60 10 10 10 10 10 10 10 10 10 10 8 8 8 8 60 
60 60 60 60 60 60 60 60 60 60 60 60 60 60 60 10 10 10 10 10 10 10 10 10 10 8 8 8 8 60 
60 60 60 60 60 60 60 60 60 60 60 60 60 60 60 10 10 10 10 10 10 10 10 10 10 8 8 8 8 60 
60 60 60 60 60 60 60 60 60 60 60 60 60 60 60 60 60 60 60 60 60 60 60 60 60 60 60 60 60 60

Thife TH 1 3

5
SeeGuard GR3 19 5 1 1.2 CL DOWN DOWN DOWN DOWN DOWN DOWN  RIGHT RIGHT RIGHT RIGHT RIGHT  RIGHT RIGHT UP UP UP UP UP UP  LEFT LEFT LEFT LEFT LEFT LEFT LEFT
HeardGuard GR6 25 4 1 1.2 CL  LEFT LEFT LEFT LEFT LEFT LEFT LEFT DOWN DOWN DOWN DOWN DOWN DOWN  RIGHT RIGHT RIGHT RIGHT RIGHT  RIGHT RIGHT UP UP UP UP UP UP
SeeGuard GR1 26 9  1 1.2 CL  UP UP UP UP UP UP  LEFT LEFT LEFT LEFT LEFT LEFT LEFT DOWN DOWN DOWN DOWN DOWN DOWN  RIGHT RIGHT RIGHT RIGHT RIGHT  RIGHT RIGHT
HeardGuard GR7 20 10 1 1.2 CL RIGHT RIGHT RIGHT RIGHT RIGHT  RIGHT RIGHT UP UP UP UP UP UP  LEFT LEFT LEFT LEFT LEFT LEFT LEFT DOWN DOWN DOWN DOWN DOWN DOWN
SeeGuard GR3 24 24 1 1.2 CL  LOOK_UP LOOK_LEFT LOOK_DOWN LOOK_RIGHT 

2
Key K1 27 27
SpeedPotion P1 25 22












