100 14
24 22 22 22 22 22 22 22 22 22 22 22 22 22 22 22 22 22 22 22 22 22 22 22 22 22 22 22 22 22 22 22 22 22 22 22 22 22 22 22 22 22 22 22 22 22 22 22 22 22 22 22 22 22 22 22 22 22 22 22 22 22 22 22 22 22 22 22 22 22 22 22 22 22 22 22 22 22 22 22 22 22 22 22 22 22 22 22 22 22 22 22 22 22 22 22 22 22 22 28 
25 2 4 2 4 2 5 5 4 4 4 5 5 4 4 5 1 1 5 5 1 1 4 4 4 2 4 5 1 1 5 5 1 1 1 5 1 1 1 1 1 5 1 1 2 6 6 6 4 5 1 1 5 5 1 1 1 1 6 1 4 5 1 1 5 5 1 1 5 5 4 4 4 2 4 2 5 5 4 4 4 5 5 4 4 4 2 4 2 5 5 4 4 4 5 5 4 4 4 25 
25 2 2 2 2 4 2 5 1 1 1 1 1 1 1 1 1 1 1 1 1 5 5 5 1 1 2 1 1 1 1 1 1 5 5 1 1 5 5 5 5 1 1 5 4 1 1 1 6 1 1 1 1 1 1 5 1 1 6 1 1 1 1 1 1 1 1 5 1 1 1 1 1 2 2 4 2 5 1 1 1 1 1 1 1 1 2 2 4 2 5 1 1 1 1 1 1 1 1 25 
25 1 1 1 1 1 6 6 6 1 1 4 4 1 4 1 1 1 1 1 1 1 1 1 1 5 1 1 1 1 1 1 1 1 1 1 1 1 1 1 1 1 1 1 4 4 4 4 1 1 1 1 1 1 1 1 1 1 1 6 4 1 1 1 1 1 1 1 4 4 1 4 1 1 1 1 6 6 6 1 1 4 4 1 4 1 1 1 1 6 6 6 1 1 4 4 1 4 1 25 
25 1 6 1 6 1 4 2 6 6 6 1 4 1 4 4 6 1 4 1 1 1 1 1 1 1 6 4 6 1 4 1 1 1 1 1 1 1 1 1 1 1 1 1 1 1 5 5 4 4 6 1 4 1 1 1 1 1 4 6 1 4 6 1 4 1 1 1 1 4 1 4 4 1 6 1 4 2 6 6 6 1 4 1 4 4 1 6 1 4 2 6 6 6 1 4 1 4 4 25 
25 1 6 1 6 1 1 4 1 1 1 2 4 4 4 1 1 1 6 4 6 1 4 1 1 1 6 1 1 4 1 1 1 2 1 1 1 1 1 1 6 1 1 1 1 1 1 1 1 5 4 4 4 4 6 1 1 1 1 1 6 1 1 1 4 1 1 1 2 4 4 4 1 1 6 1 1 4 1 1 1 2 4 4 4 1 1 6 1 1 4 1 1 1 2 4 4 4 1 25 
25 1 1 1 1 6 4 4 4 4 2 1 4 4 5 5 1 1 1 6 4 4 4 4 2 1 1 6 4 4 4 4 2 1 1 1 1 4 1 1 6 1 1 5 1 1 5 5 1 1 1 1 1 5 1 1 1 4 1 1 6 1 1 5 4 4 4 2 1 4 4 5 5 1 1 6 4 4 4 4 2 1 4 4 5 5 1 1 6 4 4 4 4 2 1 56 4 5 5 25 
25 1 4 1 4 6 1 1 1 5 5 5 1 1 1 1 1 1 4 6 1 1 1 5 5 1 4 6 1 1 1 5 5 5 6 1 4 1 1 1 1 1 1 1 1 1 1 1 1 5 6 1 1 1 4 1 4 1 1 1 1 1 1 1 1 1 5 5 5 1 1 1 1 1 4 6 1 1 1 5 5 5 1 1 1 1 1 4 6 1 1 1 5 5 5 1 1 1 1 25 
25 1 1 1 1 1 6 1 1 1 1 1 1 1 1 1 1 1 1 1 6 1 1 1 1 1 1 1 6 1 1 1 1 1 1 1 1 1 6 1 4 1 1 1 1 1 1 1 1 1 6 1 1 5 5 4 1 1 1 1 1 1 1 6 1 1 1 1 1 1 1 1 1 1 1 1 6 1 1 1 1 1 1 1 1 1 1 1 1 6 1 1 1 1 1 1 1 1 1 25 
25 4 1 4 1 1 6 1 1 5 1 1 1 1 1 1 4 4 1 1 6 1 1 5 1 4 1 1 6 1 1 5 1 1 1 1 1 1 1 1 1 1 1 4 6 1 4 1 1 1 1 1 1 1 1 1 1 1 1 1 4 1 1 6 1 1 5 1 1 1 1 1 1 4 1 1 6 1 1 5 1 1 1 1 1 1 4 1 1 6 1 1 5 1 1 1 1 1 1 25 
25 1 1 1 1 1 1 1 1 1 1 1 1 5 5 6 1 1 1 1 1 1 1 1 1 1 1 1 1 1 1 1 1 1 1 5 5 6 5 5 6 1 4 1 1 1 1 1 4 1 1 6 1 1 5 6 1 1 1 1 1 1 1 1 1 1 1 1 1 1 5 5 6 1 1 1 1 1 1 1 1 1 1 5 5 6 1 1 1 1 1 1 1 1 1 1 5 5 6 25 
25 1 1 1 1 1 4 1 5 1 1 5 5 5 1 1 1 1 1 1 4 1 5 1 1 1 1 1 4 1 5 1 1 5 5 5 1 1 5 1 1 4 1 1 1 6 1 4 1 1 1 1 1 1 1 1 1 1 1 1 1 1 1 4 1 5 1 1 5 5 5 1 1 1 1 1 4 1 5 1 1 5 5 5 1 1 1 1 1 4 1 5 1 1 5 5 5 1 1 25 
25 1 1 1 1 1 1 1 1 1 1 1 1 1 1 1 1 1 1 1 1 1 1 1 1 1 1 1 1 1 1 1 1 1 1 1 1 1 1 1 1 1 1 1 1 1 1 1 1 1 1 1 1 1 1 1 1 1 1 1 1 1 1 1 1 1 1 1 1 1 1 1 1 1 1 1 1 1 1 1 1 1 1 1 1 1 1 1 1 1 1 1 1 1 1 1 1 1 1 25 
26 22 22 22 22 22 22 22 22 22 22 22 22 22 22 22 22 22 22 22 22 22 22 22 22 22 22 22 22 22 22 22 22 22 22 22 22 22 22 22 22 22 22 22 22 22 22 22 22 22 22 22 22 22 22 22 22 22 22 22 22 22 22 22 22 22 22 22 22 22 22 22 22 22 22 22 22 22 22 22 22 22 22 22 22 22 22 22 22 22 22 22 22 22 22 22 22 22 22 30

Thief TH 2 6 


20
HeardGuard GR6 10 9 1 1.1 CL DOWN DOWN DOWN UP UP UP
HeardGuard GR6 20 9 1 1.1 CL DOWN DOWN DOWN UP UP UP
HeardGuard GR6 30 9 1 1.1 CL DOWN DOWN DOWN UP UP UP
HeardGuard GR6 40 9 1 1.1 CL DOWN DOWN DOWN UP UP UP
HeardGuard GR6 50 9 1 1.1 CL DOWN DOWN DOWN UP UP UP
HeardGuard GR6 60 9 1 1.1 CL DOWN DOWN DOWN UP UP UP
HeardGuard GR6 70 9 1 1.1 CL DOWN DOWN DOWN UP UP UP
HeardGuard GR6 80 9 1 1.1 CL DOWN DOWN DOWN UP UP UP
HeardGuard GR6 90 9 1 1.1 CL DOWN DOWN DOWN UP UP UP
HeardGuard GR6 95 9 1 1.1 CL DOWN DOWN DOWN UP UP UP
HeardGuard GR6 10 4 1 1.1 CL UP UP UP DOWN DOWN DOWN
HeardGuard GR6 20 4 1 1.1 CL UP UP UP DOWN DOWN DOWN
HeardGuard GR6 30 4 1 1.1 CL UP UP UP DOWN DOWN DOWN
HeardGuard GR6 40 4 1 1.1 CL UP UP UP DOWN DOWN DOWN
HeardGuard GR6 50 4 1 1.1 CL UP UP UP DOWN DOWN DOWN
HeardGuard GR6 60 4 1 1.1 CL UP UP UP DOWN DOWN DOWN
HeardGuard GR6 70 4 1 1.1 CL UP UP UP DOWN DOWN DOWN
HeardGuard GR6 80 4 1 1.1 CL UP UP UP DOWN DOWN DOWN
HeardGuard GR6 90 4 1 1.1 CL UP UP UP DOWN DOWN DOWN
HeardGuard GR6 95 4 1 1.1 CL UP UP UP DOWN DOWN DOWN

0